Conservatives	party=Conservative Party	twitter_handle=Conservatives
ScotTories	party=Conservative Party	twitter_handle=ScotTories
LibDems	party=Liberal Democrats	twitter_handle=LibDems
scotlibdems	party=Liberal Democrats	twitter_handle=scotlibdems
WelshLibDems	party=Liberal Democrats	twitter_handle=WelshLibDems
UKLabour	party=Labour Party	twitter_handle=UKLabour
scottishlabour	party=Labour Party	twitter_handle=scottishlabour
welshlabour	party=Labour Party	twitter_handle=welshlabour
TheGreenParty	party=Green Party	twitter_handle=TheGreenParty
scotgp	party=Green Party	twitter_handle=scotgp
WalesGreenParty	party=Green Party	twitter_handle=WalesGreenParty
GreenPartyNI	party=Green Party	twitter_handle=GreenPartyNI
theSNP	party=Scottish National Party	twitter_handle=theSNP
Plaid_Cymru	party=Plaid Cymru	twitter_handle=Plaid_Cymru
UKIP	party=UK Independence Party	twitter_handle=UKIP
duponline	party=Democratic Unionist Party	twitter_handle=duponline
uuponline	party=Ulster Unionist Party	twitter_handle=uuponline
allianceparty	party=Alliance	twitter_handle=allianceparty
sinnfeinireland	party=Sinn FÃ©in	twitter_handle=sinnfeinireland
SDLPlive	party=SDLP (Social Democratic & Labour Party)	twitter_handle=SDLPlive
bnp	party=British National Party	twitter_handle=bnp
ForChange_Now	party=Change UK	twitter_handle=ForChange_Now
brexitparty_uk	party=The Brexit Party	twitter_handle=brexitparty_uk
