Labour	party=Labour Party
Tory	party=Conservative Party
LibDem	party=Liberal Democrats
Conservative	party=Conservative Party
Lib Dem	party=Liberal Democrats
Liberal Democrat	party=Liberal Democrats
Green Party	party=Green Party
UKIP	party=UK Independence Party
Alliance Party of Northern Ireland	party=Alliance
Conservative and Unionist Party	party=Conservative Party
Democratic Unionist Party	party=Democratic Unionist Party
Green Party in Northern Ireland	party=Green Party
Green Party of England and Wales	party=Green Party
Labour Party	party=Labour Party
Liberal Democrats	party=Liberal Democrats
Liberals	party=Liberal Party
Plaid Cymru	party=Plaid Cymru
Respect Party	party=Respect
Scottish Green Party	party=Green Party
Scottish National Party	party=Scottish National Party
Sinn Féin	party=Sinn Féin
Sinn Fein	party=Sinn Féin
Social Democratic and Labour Party	party=Social Democratic and Labour Party
Traditional Unionist Voice	party=Traditional Unionist Voice
UK Independence Party	party=UK Independence Party
Ulster Unionist Party	party=Ulster Unionist Party
4 Freedoms Party	party=4 Freedoms Party
Animal Welfare Party	party=Animal Welfare Party
An Independence from Europe	party=An Independence from Europe
Liberal Party	party=Liberal Party
Libertarian Party	party=Libertarian Party
No Candidate Deserves My Vote	party=No Candidate Deserves My Vote
People's Democratic Party	party=People's Democratic Party
Peace Party	party=Peace Party
Pirate Party	party=Pirate Party
Populist Alliance	party=Populist Alliance
Social Democratic Party	party=Social Democratic Party
United in Europe	party=United in Europe
Veritas	party=Veritas
We Demand a Referendum	party=We Demand a Referendum
Conservative Party	party=Conservative Party
Conservatives	party=Conservative Party
Tories	party=Conservative Party
SNP	party=Scottish National Party
Lib Dems	party=Liberal Democrats
Change UK	party=Change UK
The Independent Group	party=Change UK
Change UK (The Independent Group)	party=Change UK
The Brexit Party	party=The Brexit Party
