WalsallGreens	party=Green Party	twitter_handle=WalsallGreens
ScarboroughLDs	party=Liberal Democrats	twitter_handle=ScarboroughLDs
SuffolkTories	party=Conservative Party	twitter_handle=SuffolkTories
NorthHerefordCA	party=Conservative Party	twitter_handle=NorthHerefordCA
BracknellLabour	party=Labour Party	twitter_handle=BracknellLabour
BoltonTories	party=Conservative Party	twitter_handle=BoltonTories
exeterlibdems	party=Liberal Democrats	twitter_handle=exeterlibdems
Tameside_Tories	party=Conservative Party	twitter_handle=Tameside_Tories
exeter_tories_	party=Conservative Party	twitter_handle=exeter_tories_
ashfordgreens	party=Green Party	twitter_handle=ashfordgreens
libdemkettering	party=Liberal Democrats	twitter_handle=libdemkettering
SwaleGreens	party=Green Party	twitter_handle=SwaleGreens
bromslibdems	party=Liberal Democrats	twitter_handle=bromslibdems
RushcliffeLibDm	party=Liberal Democrats	twitter_handle=RushcliffeLibDm
cvconservatives	party=Conservative Party	twitter_handle=cvconservatives
prestontories	party=Conservative Party	twitter_handle=prestontories
SoTConservative	party=Conservative Party	twitter_handle=SoTConservative
broxtowelabour	party=Labour Party	twitter_handle=broxtowelabour
walsallibdem	party=Liberal Democrats	twitter_handle=walsallibdem
lincsgreenparty	party=Green Party	twitter_handle=lincsgreenparty
eastlancsgreens	party=Green Party	twitter_handle=eastlancsgreens
cwaclabour	party=Labour Party	twitter_handle=cwaclabour
bluenorthderbs	party=Conservative Party	twitter_handle=bluenorthderbs
worcsgreenparty	party=Green Party	twitter_handle=worcsgreenparty
seftongreens	party=Green Party	twitter_handle=seftongreens
SpelthorneLabPy	party=Labour Party	twitter_handle=SpelthorneLabPy
maidstonecca	party=Conservative Party	twitter_handle=maidstonecca
WesthoughtonInd	party=Westhoughton First Independents	twitter_handle=WesthoughtonInd
hpconservatives	party=Conservative Party	twitter_handle=hpconservatives
HyndburnTories	party=Conservative Party	twitter_handle=HyndburnTories
leedswestlabour	party=Labour Party	twitter_handle=leedswestlabour
Rugby_Labour	party=Labour Party	twitter_handle=Rugby_Labour
torbaylibdems	party=Liberal Democrats	twitter_handle=torbaylibdems
BoltonGreens	party=Green Party	twitter_handle=BoltonGreens
ResiAssociation	party=Molesey Residents Association	twitter_handle=ResiAssociation
maidenheadLD	party=Liberal Democrats	twitter_handle=maidenheadLD
leicsgreenparty	party=Green Party	twitter_handle=leicsgreenparty
BrecklandLD	party=Liberal Democrats	twitter_handle=BrecklandLD
traffordlibdems	party=Liberal Democrats	twitter_handle=traffordlibdems
WorthingWestCLP	party=Labour Party	twitter_handle=WorthingWestCLP
DtonGreenParty	party=Green Party	twitter_handle=DtonGreenParty
LeedsGreenParty	party=Green Party	twitter_handle=LeedsGreenParty
wokinghamlibdem	party=Liberal Democrats	twitter_handle=wokinghamlibdem
basildonlabour	party=Labour Party	twitter_handle=basildonlabour
labourhighpeak	party=Labour Party	twitter_handle=labourhighpeak
f_hlibdems	party=Liberal Democrats	twitter_handle=f_hlibdems
ResidentsofW	party=Residents of Wilmslow	twitter_handle=ResidentsofW
charnwoodgreens	party=Green Party	twitter_handle=charnwoodgreens
Westoxongreens	party=Green Party	twitter_handle=Westoxongreens
ShepwayGreens	party=Green Party	twitter_handle=ShepwayGreens
TorbayTories	party=Conservative Party	twitter_handle=TorbayTories
derbyconserv	party=Conservative Party	twitter_handle=derbyconserv
reigatelibdems	party=Liberal Democrats	twitter_handle=reigatelibdems
LATTOFFICIAL	party=Leigh, Atherton & Tyldesley Together	twitter_handle=LATTOFFICIAL
winld	party=Liberal Democrats	twitter_handle=winld
wealdentories	party=Conservative Party	twitter_handle=wealdentories
newcastlefirst	party=Newcastle Independents	twitter_handle=newcastlefirst
ChorleyTories	party=Conservative Party	twitter_handle=ChorleyTories
ipswichlabour	party=Labour Party	twitter_handle=ipswichlabour
torycouncillors	party=Conservative Party	twitter_handle=torycouncillors
McrLabour	party=Labour Party	twitter_handle=McrLabour
plymouthgreens	party=Green Party	twitter_handle=plymouthgreens
AVtories	party=Conservative Party	twitter_handle=AVtories
laboursheffield	party=Labour Party	twitter_handle=laboursheffield
rugbytory	party=Conservative Party	twitter_handle=rugbytory
IpswichGreens	party=Green Party	twitter_handle=IpswichGreens
ukipwealden_	party=UK Independence Party	twitter_handle=ukipwealden_
ndlibdems	party=Liberal Democrats	twitter_handle=ndlibdems
WorthingLibDems	party=Liberal Democrats	twitter_handle=WorthingLibDems
TheGreenParty	party=Green Party	twitter_handle=TheGreenParty
mansfieldlabour	party=Labour Party	twitter_handle=mansfieldlabour
cotswoldgreens	party=Green Party	twitter_handle=cotswoldgreens
ica_suffolk	party=Conservative Party	twitter_handle=ica_suffolk
ukipnorwich	party=UK Independence Party	twitter_handle=ukipnorwich
CambridgeLabour	party=Labour Party	twitter_handle=CambridgeLabour
LeedsCityTories	party=Conservative Party	twitter_handle=LeedsCityTories
CannockChaseGP	party=Green Party	twitter_handle=CannockChaseGP
sevenoaksclp	party=Labour Party	twitter_handle=sevenoaksclp
SocialistSouth	party=Socialist Party	twitter_handle=SocialistSouth
Broxlibdems	party=Liberal Democrats	twitter_handle=Broxlibdems
SolihullGreens	party=Green Party	twitter_handle=SolihullGreens
wokinglibdems	party=Liberal Democrats	twitter_handle=wokinglibdems
harlowlabour	party=Labour Party	twitter_handle=harlowlabour
MDTories	party=Conservative Party	twitter_handle=MDTories
GreenPartyNT	party=Green Party	twitter_handle=GreenPartyNT
PompeyToryParty	party=Conservative Party	twitter_handle=PompeyToryParty
ReadingLabour	party=Labour Party	twitter_handle=ReadingLabour
NottmLibDems	party=Liberal Democrats	twitter_handle=NottmLibDems
midsuffolkgreen	party=Green Party	twitter_handle=midsuffolkgreen
wokinghamgreens	party=Green Party	twitter_handle=wokinghamgreens
MaldonLabour	party=Labour Party	twitter_handle=MaldonLabour
ukipnthhereford	party=UK Independence Party	twitter_handle=ukipnthhereford
ukipswale	party=UK Independence Party	twitter_handle=ukipswale
Liverlibdems	party=Liberal Democrats	twitter_handle=Liverlibdems
CoventryLabour	party=Labour Party	twitter_handle=CoventryLabour
fyldeca	party=Conservative Party	twitter_handle=fyldeca
liverpoollabour	party=Labour Party	twitter_handle=liverpoollabour
CumbriaLibDems	party=Liberal Democrats	twitter_handle=CumbriaLibDems
UKIP	party=UK Independence Party	twitter_handle=UKIP
ukip_reading	party=UK Independence Party	twitter_handle=ukip_reading
labouryork	party=Labour Party	twitter_handle=labouryork
RBWMTories	party=Conservative Party	twitter_handle=RBWMTories
WorkingtonCA	party=Conservative Party	twitter_handle=WorkingtonCA
knowsleylibdems	party=Liberal Democrats	twitter_handle=knowsleylibdems
surreyheathlab	party=Labour Party	twitter_handle=surreyheathlab
EastHertsGreen	party=Green Party	twitter_handle=EastHertsGreen
twlabour	party=Labour Party	twitter_handle=twlabour
waverleylibdems	party=Liberal Democrats	twitter_handle=waverleylibdems
medwaygreens	party=Green Party	twitter_handle=medwaygreens
BwdOngrLabour	party=Labour Party	twitter_handle=BwdOngrLabour
northamptonlds	party=Liberal Democrats	twitter_handle=northamptonlds
ourwestlancs	party=	twitter_handle=ourwestlancs
TWDCA1	party=	twitter_handle=TWDCA1
SNorfolkTories	party=Conservative Party	twitter_handle=SNorfolkTories
localalliance1	party=	twitter_handle=localalliance1
swaletories	party=Conservative Party	twitter_handle=swaletories
liverpoolgreens	party=Green Party	twitter_handle=liverpoolgreens
bedfordlabour	party=Labour Party	twitter_handle=bedfordlabour
SevenoaksLibDem	party=Liberal Democrats	twitter_handle=SevenoaksLibDem
mklabourparty	party=Labour Party	twitter_handle=mklabourparty
southglosgreens	party=Green Party	twitter_handle=southglosgreens
slandtories	party=Conservative Party	twitter_handle=slandtories
TandWCons	party=Conservative Party	twitter_handle=TandWCons
LabourNorth	party=Labour Party	twitter_handle=LabourNorth
AbrValleyLibDem	party=Liberal Democrats	twitter_handle=AbrValleyLibDem
NewtonAbbotCA	party=Conservative Party	twitter_handle=NewtonAbbotCA
FavConservative	party=Conservative Party	twitter_handle=FavConservative
wearsidelibdem	party=Liberal Democrats	twitter_handle=wearsidelibdem
TeesUkip	party=UK Independence Party	twitter_handle=TeesUkip
christchurchlab	party=Labour Party	twitter_handle=christchurchlab
secambslibdems	party=Liberal Democrats	twitter_handle=secambslibdems
WOCA_News	party=Conservative Party	twitter_handle=WOCA_News
nwarksconserv	party=Conservative Party	twitter_handle=nwarksconserv
BromsTories	party=Conservative Party	twitter_handle=BromsTories
ukipcoventry	party=UK Independence Party	twitter_handle=ukipcoventry
7oaksTories	party=Conservative Party	twitter_handle=7oaksTories
UKIPWigan	party=UK Independence Party	twitter_handle=UKIPWigan
MedwayLabour	party=Labour Party	twitter_handle=MedwayLabour
McrGreenParty	party=Green Party	twitter_handle=McrGreenParty
wealdengp	party=Green Party	twitter_handle=wealdengp
FutureHemel	party=	twitter_handle=FutureHemel
hertsmeretories	party=Conservative Party	twitter_handle=hertsmeretories
Southend_Tories	party=Conservative Party	twitter_handle=Southend_Tories
NorwichGreens	party=Green Party	twitter_handle=NorwichGreens
secambslabour	party=Labour Party	twitter_handle=secambslabour
Portisheadindys	party=	twitter_handle=Portisheadindys
SEDGreens	party=Green Party	twitter_handle=SEDGreens
ukipcalderdale	party=UK Independence Party	twitter_handle=ukipcalderdale
richmondshireld	party=Liberal Democrats	twitter_handle=richmondshireld
labour4wirral	party=Labour Party	twitter_handle=labour4wirral
bradfordgreens	party=Green Party	twitter_handle=bradfordgreens
BeverleyParty	party=	twitter_handle=BeverleyParty
ukipsthelens	party=UK Independence Party	twitter_handle=ukipsthelens
epsomlibdem	party=Liberal Democrats	twitter_handle=epsomlibdem
CorbyENLabour	party=Labour Party	twitter_handle=CorbyENLabour
BoltonLibDems	party=Liberal Democrats	twitter_handle=BoltonLibDems
RdgTories	party=Conservative Party	twitter_handle=RdgTories
sandwelllibdems	party=Liberal Democrats	twitter_handle=sandwelllibdems
harlowparty	party=	twitter_handle=harlowparty
BathLabourParty	party=Labour Party	twitter_handle=BathLabourParty
sthelensgreens	party=Green Party	twitter_handle=sthelensgreens
NEHertsTories	party=Conservative Party	twitter_handle=NEHertsTories
bolsover_clp	party=Labour Party	twitter_handle=bolsover_clp
MeltonBlue	party=Conservative Party	twitter_handle=MeltonBlue
chichesterca	party=Conservative Party	twitter_handle=chichesterca
eastbourneclp	party=Labour Party	twitter_handle=eastbourneclp
nchlibdems	party=Liberal Democrats	twitter_handle=nchlibdems
LabourinDerby	party=Labour Party	twitter_handle=LabourinDerby
bassetlawlibdem	party=Liberal Democrats	twitter_handle=bassetlawlibdem
ukip_trafford	party=UK Independence Party	twitter_handle=ukip_trafford
selbygreenparty	party=Green Party	twitter_handle=selbygreenparty
ambervgreens	party=Green Party	twitter_handle=ambervgreens
mhlibdems	party=Liberal Democrats	twitter_handle=mhlibdems
LabourCoast	party=Labour Party	twitter_handle=LabourCoast
NewcastleLibDem	party=Liberal Democrats	twitter_handle=NewcastleLibDem
BigIndependents	party=	twitter_handle=BigIndependents
nwblabour	party=Labour Party	twitter_handle=nwblabour
broadlandlibdem	party=Liberal Democrats	twitter_handle=broadlandlibdem
TWlibdems	party=Liberal Democrats	twitter_handle=TWlibdems
newforestgreens	party=Green Party	twitter_handle=newforestgreens
caldergreens	party=Green Party	twitter_handle=caldergreens
LewesGreenParty	party=Green Party	twitter_handle=LewesGreenParty
TunbridgeW_cca	party=Conservative Party	twitter_handle=TunbridgeW_cca
TelfordLabour	party=Labour Party	twitter_handle=TelfordLabour
graveshamtories	party=Conservative Party	twitter_handle=graveshamtories
eastdevonlabour	party=Labour Party	twitter_handle=eastdevonlabour
eastleighlab	party=Labour Party	twitter_handle=eastleighlab
NSLabour	party=Labour Party	twitter_handle=NSLabour
BridgendYngLab	party=Labour Party	twitter_handle=BridgendYngLab
hertsmereclp	party=Labour Party	twitter_handle=hertsmereclp
ThanetGreen	party=Green Party	twitter_handle=ThanetGreen
BathNESGreens	party=Green Party	twitter_handle=BathNESGreens
crewelabour	party=Labour Party	twitter_handle=crewelabour
TeamTorbay	party=	twitter_handle=TeamTorbay
knowsleygreens	party=Green Party	twitter_handle=knowsleygreens
hemellibdems	party=Liberal Democrats	twitter_handle=hemellibdems
npton_cons	party=Conservative Party	twitter_handle=npton_cons
BathCA	party=Conservative Party	twitter_handle=BathCA
broxlabour	party=Labour Party	twitter_handle=broxlabour
harlowlibdems	party=Liberal Democrats	twitter_handle=harlowlibdems
BroxtoweCons	party=Conservative Party	twitter_handle=BroxtoweCons
yorklibdems	party=Liberal Democrats	twitter_handle=yorklibdems
officialSPGB	party=	twitter_handle=officialSPGB
shepwaylabour	party=Labour Party	twitter_handle=shepwaylabour
LibDems	party=Liberal Democrats	twitter_handle=LibDems
Mid_Sussex	party=	twitter_handle=Mid_Sussex
swaleia	party=	twitter_handle=swaleia
StockportGreens	party=Green Party	twitter_handle=StockportGreens
NDerbysLibDems	party=Liberal Democrats	twitter_handle=NDerbysLibDems
MCRLibDems	party=Liberal Democrats	twitter_handle=MCRLibDems
fyldelabour	party=Labour Party	twitter_handle=fyldelabour
plymouthlibdems	party=Liberal Democrats	twitter_handle=plymouthlibdems
dacorumgreens	party=Green Party	twitter_handle=dacorumgreens
mkgreens	party=Green Party	twitter_handle=mkgreens
borolibdems	party=Liberal Democrats	twitter_handle=borolibdems
stratfordlabour	party=Labour Party	twitter_handle=stratfordlabour
hullukip	party=UK Independence Party	twitter_handle=hullukip
ALLLocalLiving	party=	twitter_handle=ALLLocalLiving
LancsFleetTorys	party=Conservative Party	twitter_handle=LancsFleetTorys
slakeslabour	party=Labour Party	twitter_handle=slakeslabour
southendlabour	party=Labour Party	twitter_handle=southendlabour
ChelmsLibDems	party=Liberal Democrats	twitter_handle=ChelmsLibDems
norwichtories	party=Conservative Party	twitter_handle=norwichtories
dartford_labour	party=Labour Party	twitter_handle=dartford_labour
exeterlabour	party=Labour Party	twitter_handle=exeterlabour
UKIPStAlbans	party=UK Independence Party	twitter_handle=UKIPStAlbans
labourhpool	party=Labour Party	twitter_handle=labourhpool
maidstonelibdem	party=Liberal Democrats	twitter_handle=maidstonelibdem
bridgendgreens	party=Green Party	twitter_handle=bridgendgreens
Barnsley_Greens	party=Green Party	twitter_handle=Barnsley_Greens
TWellsAlliance	party=	twitter_handle=TWellsAlliance
LoughtonRA	party=	twitter_handle=LoughtonRA
hemellabour	party=Labour Party	twitter_handle=hemellabour
NTynesideLab	party=Labour Party	twitter_handle=NTynesideLab
Morley_Boroughs	party=	twitter_handle=Morley_Boroughs
NorthTyneLDs	party=Liberal Democrats	twitter_handle=NorthTyneLDs
WoollenDistrict	party=	twitter_handle=WoollenDistrict
nuneatongreen	party=Green Party	twitter_handle=nuneatongreen
mvlibdems	party=Liberal Democrats	twitter_handle=mvlibdems
HarlowGP	party=Green Party	twitter_handle=HarlowGP
medwaylibdems	party=Liberal Democrats	twitter_handle=medwaylibdems
bradfordlabour	party=Labour Party	twitter_handle=bradfordlabour
TWellsGreen	party=Green Party	twitter_handle=TWellsGreen
Conservatives	party=Conservative Party	twitter_handle=Conservatives
epsomewellra	party=	twitter_handle=epsomewellra
WatfordLabour	party=Labour Party	twitter_handle=WatfordLabour
SWLibDems	party=Liberal Democrats	twitter_handle=SWLibDems
redditchlibdems	party=Liberal Democrats	twitter_handle=redditchlibdems
stevenagelabour	party=Labour Party	twitter_handle=stevenagelabour
ukipfylde	party=UK Independence Party	twitter_handle=ukipfylde
UKIPMK	party=UK Independence Party	twitter_handle=UKIPMK
SandwellGreens	party=Green Party	twitter_handle=SandwellGreens
northstaffsgp	party=Green Party	twitter_handle=northstaffsgp
thanetlab	party=Labour Party	twitter_handle=thanetlab
UKIPCumbria	party=UK Independence Party	twitter_handle=UKIPCumbria
sandwelltories	party=Conservative Party	twitter_handle=sandwelltories
DerbysLabour	party=Labour Party	twitter_handle=DerbysLabour
portsmouthld	party=Liberal Democrats	twitter_handle=portsmouthld
olsconservative	party=Conservative Party	twitter_handle=olsconservative
NCLGreenParty	party=Green Party	twitter_handle=NCLGreenParty
castlepointlab	party=Labour Party	twitter_handle=castlepointlab
easthantsgreens	party=Green Party	twitter_handle=easthantsgreens
NewcastleTories	party=Conservative Party	twitter_handle=NewcastleTories
ukip_pbo	party=UK Independence Party	twitter_handle=ukip_pbo
EastBerksGP	party=Green Party	twitter_handle=EastBerksGP
dartfordlibdems	party=Liberal Democrats	twitter_handle=dartfordlibdems
winch_labour	party=Labour Party	twitter_handle=winch_labour
HartlepoolGroup	party=	twitter_handle=HartlepoolGroup
lewescons	party=Conservative Party	twitter_handle=lewescons
boro_libdems	party=Liberal Democrats	twitter_handle=boro_libdems
GreensStratford	party=Green Party	twitter_handle=GreensStratford
newburygreens	party=Green Party	twitter_handle=newburygreens
lutonlabour1	party=Labour Party	twitter_handle=lutonlabour1
SotonInTouch	party=	twitter_handle=SotonInTouch
efgreens	party=Green Party	twitter_handle=efgreens
harlowtories	party=Conservative Party	twitter_handle=harlowtories
ndlabourparty	party=Labour Party	twitter_handle=ndlabourparty
BuryTories	party=Conservative Party	twitter_handle=BuryTories
bromsgrovelab	party=Labour Party	twitter_handle=bromsgrovelab
WDorsetLabour	party=Labour Party	twitter_handle=WDorsetLabour
LTConservatives	party=Conservative Party	twitter_handle=LTConservatives
ukipsunderland	party=UK Independence Party	twitter_handle=ukipsunderland
SloughTory	party=Conservative Party	twitter_handle=SloughTory
bhlabour	party=Labour Party	twitter_handle=bhlabour
hyndburn_labour	party=Labour Party	twitter_handle=hyndburn_labour
ee_labour	party=Labour Party	twitter_handle=ee_labour
SheffieldUKIP	party=UK Independence Party	twitter_handle=SheffieldUKIP
sgloslibdems	party=Liberal Democrats	twitter_handle=sgloslibdems
stevenagelibdem	party=Liberal Democrats	twitter_handle=stevenagelibdem
labsouthsuffolk	party=Labour Party	twitter_handle=labsouthsuffolk
greenhereford	party=Green Party	twitter_handle=greenhereford
ukipnottingham	party=UK Independence Party	twitter_handle=ukipnottingham
WitneyLabourCLP	party=Labour Party	twitter_handle=WitneyLabourCLP
UKIPScarWhitby	party=UK Independence Party	twitter_handle=UKIPScarWhitby
conservativessd	party=Conservative Party	twitter_handle=conservativessd
GuildfordLibDem	party=Liberal Democrats	twitter_handle=GuildfordLibDem
ashfordcca	party=Conservative Party	twitter_handle=ashfordcca
theboroughfirst	party=	twitter_handle=theboroughfirst
wyreforestlab	party=Labour Party	twitter_handle=wyreforestlab
WakefieldTories	party=Conservative Party	twitter_handle=WakefieldTories
Woking_Cons	party=Conservative Party	twitter_handle=Woking_Cons
swindongreens	party=Green Party	twitter_handle=swindongreens
lincolnlabour	party=Labour Party	twitter_handle=lincolnlabour
RutlandMeltonGP	party=Green Party	twitter_handle=RutlandMeltonGP
penybontplaid	party=	twitter_handle=penybontplaid
nottsgreenparty	party=Green Party	twitter_handle=nottsgreenparty
EastCambsGreens	party=Green Party	twitter_handle=EastCambsGreens
wealdenld	party=Liberal Democrats	twitter_handle=wealdenld
bedfordgreens	party=Green Party	twitter_handle=bedfordgreens
CarlisleGreens	party=Green Party	twitter_handle=CarlisleGreens
ColcGreenParty	party=Green Party	twitter_handle=ColcGreenParty
herefordlibdems	party=Liberal Democrats	twitter_handle=herefordlibdems
UKIP_Stockport	party=UK Independence Party	twitter_handle=UKIP_Stockport
wycombelibdems	party=Liberal Democrats	twitter_handle=wycombelibdems
herefordlabour	party=Labour Party	twitter_handle=herefordlabour
StAlbansLDs	party=Liberal Democrats	twitter_handle=StAlbansLDs
SomersetMatters	party=	twitter_handle=SomersetMatters
barrowclp	party=Labour Party	twitter_handle=barrowclp
colchesterlab	party=Labour Party	twitter_handle=colchesterlab
covgreenparty	party=Green Party	twitter_handle=covgreenparty
Lewes_Lib_Dems	party=Liberal Democrats	twitter_handle=Lewes_Lib_Dems
fyldelibdems	party=Liberal Democrats	twitter_handle=fyldelibdems
congletonlabour	party=Labour Party	twitter_handle=congletonlabour
ddlabour	party=Labour Party	twitter_handle=ddlabour
SeftCenCA	party=Conservative Party	twitter_handle=SeftCenCA
warwicktories	party=Conservative Party	twitter_handle=warwicktories
gainsboroughlab	party=Labour Party	twitter_handle=gainsboroughlab
RVLabour	party=Labour Party	twitter_handle=RVLabour
bracknelllibdem	party=Liberal Democrats	twitter_handle=bracknelllibdem
MalvernGreens	party=Green Party	twitter_handle=MalvernGreens
LeicesterCons	party=Conservative Party	twitter_handle=LeicesterCons
UKIPHarlow	party=UK Independence Party	twitter_handle=UKIPHarlow
ukippreston	party=UK Independence Party	twitter_handle=ukippreston
TDResidents	party=	twitter_handle=TDResidents
sshieldslabour	party=Labour Party	twitter_handle=sshieldslabour
forestlibdems	party=Liberal Democrats	twitter_handle=forestlibdems
gylabour	party=Labour Party	twitter_handle=gylabour
TelfordGreens	party=Green Party	twitter_handle=TelfordGreens
RugbyLibDems	party=Liberal Democrats	twitter_handle=RugbyLibDems
WolvesConservat	party=Conservative Party	twitter_handle=WolvesConservat
torbaygreenpart	party=Green Party	twitter_handle=torbaygreenpart
sualibdems	party=Liberal Democrats	twitter_handle=sualibdems
bwdconservative	party=Conservative Party	twitter_handle=bwdconservative
aylesburylabour	party=Labour Party	twitter_handle=aylesburylabour
ukipsloughwind	party=UK Independence Party	twitter_handle=ukipsloughwind
NorthLancsGreen	party=Green Party	twitter_handle=NorthLancsGreen
TorySwindon	party=Conservative Party	twitter_handle=TorySwindon
soton_libdems	party=Liberal Democrats	twitter_handle=soton_libdems
CarlisleCA	party=Conservative Party	twitter_handle=CarlisleCA
ChiBogGreen	party=Green Party	twitter_handle=ChiBogGreen
Darlolabour	party=Labour Party	twitter_handle=Darlolabour
salfordlibdems	party=Liberal Democrats	twitter_handle=salfordlibdems
plymouthlabour	party=Labour Party	twitter_handle=plymouthlabour
s_northants_clp	party=Labour Party	twitter_handle=s_northants_clp
reading_greens	party=Green Party	twitter_handle=reading_greens
burylibdems	party=Liberal Democrats	twitter_handle=burylibdems
haltonclp	party=Labour Party	twitter_handle=haltonclp
Trafford_Labour	party=Labour Party	twitter_handle=Trafford_Labour
teessidegreens	party=Green Party	twitter_handle=teessidegreens
WorcesterLabour	party=Labour Party	twitter_handle=WorcesterLabour
labourrochdale	party=Labour Party	twitter_handle=labourrochdale
leamgreens	party=Green Party	twitter_handle=leamgreens
southstaffsgp	party=Green Party	twitter_handle=southstaffsgp
horshamlibdems	party=Liberal Democrats	twitter_handle=horshamlibdems
haltonlibdems	party=Liberal Democrats	twitter_handle=haltonlibdems
SotonIndies	party=	twitter_handle=SotonIndies
best4luton	party=	twitter_handle=best4luton
DudleyGreenPrty	party=Green Party	twitter_handle=DudleyGreenPrty
itsourcounty	party=	twitter_handle=itsourcounty
boltonlabour	party=Labour Party	twitter_handle=boltonlabour
labrossendale	party=Labour Party	twitter_handle=labrossendale
BlackpoolLabour	party=Labour Party	twitter_handle=BlackpoolLabour
epsomewellca	party=Conservative Party	twitter_handle=epsomewellca
UKIPBedfordshi1	party=UK Independence Party	twitter_handle=UKIPBedfordshi1
PfieldLabour	party=Labour Party	twitter_handle=PfieldLabour
alderleyfirst	party=	twitter_handle=alderleyfirst
WWRA1	party=	twitter_handle=WWRA1
labour_carlisle	party=Labour Party	twitter_handle=labour_carlisle
Poole_People	party=	twitter_handle=Poole_People
Ashford_UKIP	party=UK Independence Party	twitter_handle=Ashford_UKIP
bfdlibdems	party=Liberal Democrats	twitter_handle=bfdlibdems
erewashgreen	party=Green Party	twitter_handle=erewashgreen
stalbansgreens	party=Green Party	twitter_handle=stalbansgreens
rugbygreens	party=Green Party	twitter_handle=rugbygreens
LewesLabour	party=Labour Party	twitter_handle=LewesLabour
redcarlibdems	party=Liberal Democrats	twitter_handle=redcarlibdems
shefflibdems	party=Liberal Democrats	twitter_handle=shefflibdems
eastleighld	party=Liberal Democrats	twitter_handle=eastleighld
newcastlelabour	party=Labour Party	twitter_handle=newcastlelabour
poolelibdems	party=Liberal Democrats	twitter_handle=poolelibdems
LichfieldGreens	party=Green Party	twitter_handle=LichfieldGreens
gatesheadlibdem	party=Liberal Democrats	twitter_handle=gatesheadlibdem
KetteringGreens	party=Green Party	twitter_handle=KetteringGreens
SotonGreenParty	party=Green Party	twitter_handle=SotonGreenParty
liverpooltories	party=Conservative Party	twitter_handle=liverpooltories
selbyandainsty	party=	twitter_handle=selbyandainsty
ConservBridgend	party=Conservative Party	twitter_handle=ConservBridgend
burnleylabour	party=Labour Party	twitter_handle=burnleylabour
shieldstories	party=Conservative Party	twitter_handle=shieldstories
wiganlabour	party=Labour Party	twitter_handle=wiganlabour
WestWorcsLab	party=Labour Party	twitter_handle=WestWorcsLab
PompeyLabour	party=Labour Party	twitter_handle=PompeyLabour
lincolnlibdems	party=Liberal Democrats	twitter_handle=lincolnlibdems
medwayukip	party=UK Independence Party	twitter_handle=medwayukip
sittshepplabour	party=Labour Party	twitter_handle=sittshepplabour
calderdale_ld	party=Liberal Democrats	twitter_handle=calderdale_ld
BeaconsfieldCCA	party=Conservative Party	twitter_handle=BeaconsfieldCCA
RBConservative	party=Conservative Party	twitter_handle=RBConservative
nngreenparty	party=Green Party	twitter_handle=nngreenparty
selbylabour	party=Labour Party	twitter_handle=selbylabour
cotswoldlibdems	party=Liberal Democrats	twitter_handle=cotswoldlibdems
ukip_hemel	party=UK Independence Party	twitter_handle=ukip_hemel
libdemsinhull	party=	twitter_handle=libdemsinhull
LabourNFW	party=Labour Party	twitter_handle=LabourNFW
wealdenlabour	party=Labour Party	twitter_handle=wealdenlabour
CovLibDems	party=Liberal Democrats	twitter_handle=CovLibDems
borolabour	party=Labour Party	twitter_handle=borolabour
FavershamLabour	party=Labour Party	twitter_handle=FavershamLabour
SWDorsetGreens	party=Green Party	twitter_handle=SWDorsetGreens
calderlabour	party=Labour Party	twitter_handle=calderlabour
WEHovePortslade	party=	twitter_handle=WEHovePortslade
MCRConservative	party=Conservative Party	twitter_handle=MCRConservative
NDerbysLibDems	party=Liberal Democrats	twitter_handle=NDerbysLibDems
Labour4C	party=Labour Party	twitter_handle=Labour4C
FavLibDemPress	party=Liberal Democrats	twitter_handle=FavLibDemPress
SEEGreenParty	party=Green Party	twitter_handle=SEEGreenParty
labourchase	party=Labour Party	twitter_handle=labourchase
ConservativesYO	party=Conservative Party	twitter_handle=ConservativesYO
YorkGreens	party=Green Party	twitter_handle=YorkGreens
KIGreenParty	party=Green Party	twitter_handle=KIGreenParty
sglabour	party=Labour Party	twitter_handle=sglabour
wirralgreens	party=Green Party	twitter_handle=wirralgreens
ukip_cambs	party=UK Independence Party	twitter_handle=ukip_cambs
StAlbansLabour	party=Labour Party	twitter_handle=StAlbansLabour
ukip_westlancs	party=UK Independence Party	twitter_handle=ukip_westlancs
chilabour_15	party=Labour Party	twitter_handle=chilabour_15
TheIndUnion	party=	twitter_handle=TheIndUnion
NFELabour	party=Labour Party	twitter_handle=NFELabour
burtonuttoxclp	party=Labour Party	twitter_handle=burtonuttoxclp
NSomersetLDs	party=Liberal Democrats	twitter_handle=NSomersetLDs
ukipexeter	party=UK Independence Party	twitter_handle=ukipexeter
WyreLib	party=Liberal Democrats	twitter_handle=WyreLib
copelandtories	party=Conservative Party	twitter_handle=copelandtories
newtonabbotLD	party=Liberal Democrats	twitter_handle=newtonabbotLD
nhgp	party=Green Party	twitter_handle=nhgp
EastbourneGreen	party=Green Party	twitter_handle=EastbourneGreen
GreensWolves	party=Green Party	twitter_handle=GreensWolves
nehertslabour	party=Labour Party	twitter_handle=nehertslabour
libdems_ipswich	party=	twitter_handle=libdems_ipswich
exetergreens	party=Green Party	twitter_handle=exetergreens
basildontories	party=Conservative Party	twitter_handle=basildontories
mkconservatives	party=Conservative Party	twitter_handle=mkconservatives
bollingtonfirst	party=	twitter_handle=bollingtonfirst
derbylibdems	party=Liberal Democrats	twitter_handle=derbylibdems
tcatory	party=Conservative Party	twitter_handle=tcatory
WHLabour	party=Labour Party	twitter_handle=WHLabour
DarloCons	party=Conservative Party	twitter_handle=DarloCons
SomersetLabour	party=Labour Party	twitter_handle=SomersetLabour
bedfordlibdems	party=Liberal Democrats	twitter_handle=bedfordlibdems
NECambsGreens	party=Green Party	twitter_handle=NECambsGreens
chilterngreens	party=Green Party	twitter_handle=chilterngreens
ng_labour	party=Labour Party	twitter_handle=ng_labour
rochdalegreens	party=Green Party	twitter_handle=rochdalegreens
cumbriafirst	party=	twitter_handle=cumbriafirst
ChesterTories	party=Conservative Party	twitter_handle=ChesterTories
DaventryLibDems	party=Liberal Democrats	twitter_handle=DaventryLibDems
LibDemsLuton	party=Liberal Democrats	twitter_handle=LibDemsLuton
labourmacc	party=Labour Party	twitter_handle=labourmacc
ashfieldlabour	party=Labour Party	twitter_handle=ashfieldlabour
ColneValleyCons	party=Conservative Party	twitter_handle=ColneValleyCons
WokinghamLabour	party=Labour Party	twitter_handle=WokinghamLabour
wickford_indepe	party=	twitter_handle=wickford_indepe
allerdalegreens	party=Green Party	twitter_handle=allerdalegreens
eylabour	party=Labour Party	twitter_handle=eylabour
thurrockindy	party=	twitter_handle=thurrockindy
Ssomersetgreens	party=Green Party	twitter_handle=Ssomersetgreens
LibDemsBevHold	party=Liberal Democrats	twitter_handle=LibDemsBevHold
prestonlabour	party=Labour Party	twitter_handle=prestonlabour
MVLabourParty	party=Labour Party	twitter_handle=MVLabourParty
KirkleesLibDems	party=Liberal Democrats	twitter_handle=KirkleesLibDems
npton_labour	party=Labour Party	twitter_handle=npton_labour
charnwoodclp	party=Labour Party	twitter_handle=charnwoodclp
towcesterfocus	party=	twitter_handle=towcesterfocus
BuryGreenParty	party=Green Party	twitter_handle=BuryGreenParty
lnconservatives	party=Conservative Party	twitter_handle=lnconservatives
SnCons	party=Conservative Party	twitter_handle=SnCons
labsouthswindon	party=Labour Party	twitter_handle=labsouthswindon
Worcester_Tory	party=Conservative Party	twitter_handle=Worcester_Tory
readinglibdems	party=Liberal Democrats	twitter_handle=readinglibdems
SRConservatives	party=Conservative Party	twitter_handle=SRConservatives
aylesburytories	party=Conservative Party	twitter_handle=aylesburytories
StalyTownParty	party=	twitter_handle=StalyTownParty
necambslabour	party=Labour Party	twitter_handle=necambslabour
CambridgeGreens	party=Green Party	twitter_handle=CambridgeGreens
traffordblue	party=	twitter_handle=traffordblue
ukipnorthampton	party=UK Independence Party	twitter_handle=ukipnorthampton
ReadingLabour	party=Labour Party	twitter_handle=ReadingLabour
wycombelabour	party=Labour Party	twitter_handle=wycombelabour
horshamlabour	party=Labour Party	twitter_handle=horshamlabour
slconservatives	party=Conservative Party	twitter_handle=slconservatives
havantlibdems	party=Liberal Democrats	twitter_handle=havantlibdems
barfcons	party=Conservative Party	twitter_handle=barfcons
ErewashLabour	party=Labour Party	twitter_handle=ErewashLabour
pompeygreens	party=Green Party	twitter_handle=pompeygreens
GreenPartyFOD	party=Green Party	twitter_handle=GreenPartyFOD
SRLabour	party=Labour Party	twitter_handle=SRLabour
NorwichLabour	party=Labour Party	twitter_handle=NorwichLabour
coltories	party=Conservative Party	twitter_handle=coltories
ForumMansfield	party=	twitter_handle=ForumMansfield
BHGreens	party=Green Party	twitter_handle=BHGreens
haverhilllabour	party=Labour Party	twitter_handle=haverhilllabour
soton_labour	party=Labour Party	twitter_handle=soton_labour
baberghlibdems	party=Liberal Democrats	twitter_handle=baberghlibdems
chesterlibdems	party=Liberal Democrats	twitter_handle=chesterlibdems
LDTelfordWrekin	party=Liberal Democrats	twitter_handle=LDTelfordWrekin
HMRConservative	party=Conservative Party	twitter_handle=HMRConservative
TendringFirst1	party=	twitter_handle=TendringFirst1
traffordgreens	party=Green Party	twitter_handle=traffordgreens
wycombetories	party=Conservative Party	twitter_handle=wycombetories
tamworth_clp	party=Labour Party	twitter_handle=tamworth_clp
Ashfield_Con	party=Conservative Party	twitter_handle=Ashfield_Con
WestBerksTories	party=Conservative Party	twitter_handle=WestBerksTories
rmlabour	party=Labour Party	twitter_handle=rmlabour
edevonalliance	party=	twitter_handle=edevonalliance
tauntongreens	party=Green Party	twitter_handle=tauntongreens
GedlingTories	party=Conservative Party	twitter_handle=GedlingTories
SpelthorneLibDe	party=Liberal Democrats	twitter_handle=SpelthorneLibDe
tamesidelibdems	party=Liberal Democrats	twitter_handle=tamesidelibdems
Mans_AshLibDems	party=Liberal Democrats	twitter_handle=Mans_AshLibDems
TandM_Greens	party=Green Party	twitter_handle=TandM_Greens
StocktonLibDems	party=Liberal Democrats	twitter_handle=StocktonLibDems
fhconservatives	party=Conservative Party	twitter_handle=fhconservatives
UKIPNT	party=UK Independence Party	twitter_handle=UKIPNT
sunderlandlab	party=Labour Party	twitter_handle=sunderlandlab
chorleylabour	party=Labour Party	twitter_handle=chorleylabour
graveshamlabour	party=Labour Party	twitter_handle=graveshamlabour
staffordlabour	party=Labour Party	twitter_handle=staffordlabour
conservgains	party=Conservative Party	twitter_handle=conservgains
BRLLabour	party=Labour Party	twitter_handle=BRLLabour
clangreens	party=Green Party	twitter_handle=clangreens
MedwayTories	party=Conservative Party	twitter_handle=MedwayTories
stynelibdems	party=Liberal Democrats	twitter_handle=stynelibdems
Chelmsford_Cons	party=Conservative Party	twitter_handle=Chelmsford_Cons
LibDemPress	party=Liberal Democrats	twitter_handle=LibDemPress
BathNESUKIP	party=UK Independence Party	twitter_handle=BathNESUKIP
wokinglabour	party=Labour Party	twitter_handle=wokinglabour
mklibdems	party=Liberal Democrats	twitter_handle=mklibdems
CambridgeTories	party=Conservative Party	twitter_handle=CambridgeTories
labourknowsley	party=Labour Party	twitter_handle=labourknowsley
IntegritySoton	party=Integrity	twitter_handle=IntegritySoton
Sheffieldtories	party=Conservative Party	twitter_handle=Sheffieldtories
